df	metronome
alex-1	w.SwS.wS.wS.wS.wS|wS.wS.wS.w.SwS.w.S|wS.wS.wS.wS.w.S.wS|w.Sw.Sw.S.wSwS.wS|wS.wS.wS.wS.wS.wS|wS.w.S.wS.wS.wS.wS|wS.wSwS.wS.wS.wS|wS.wS.w.S.w.S.wS.wS|wS.w.Sw.S.w.SwS.wS|wS.wS.wS.wS.w.S.wS|wS.wS.wS.wS.wS.wS|wS.w.Sw.S.wS.wS.w.S|wS.wSw.S.wS.wS.wS|w.Sw.S.wS.wSwS.wS|wSwS.wS.wS.w.Sw.S|wS.wS.wS.wS.wS.wS|w.Sw.S.wS.wS.wS.wS|wSw.SwS.wS.wS.wS|
alex-2	wSw.SwS.w.Sw.Sw.S|wSw.Sw.S.wSw.Sw.S|wS.wSw.S.wS.w.Sw.S|wS.wS.wS.wS.wSw.S|wS.wSw.S.w.Sw.S.wS|wS.wS.w.S.wSw.Sw.S|wS.wS.w.S.wS.wS.wS|wSw.S.wS.w.S.wSw.S|wS.w.Sw.S.w.Sw.SwS|
alex-3	w.S.wSw.S.wSw.Sw.S|w.Sw.SwS.wS.wSw.S|wS.wS.wS.wS.wSwS|wSwS.wS.wS.wS.wS|w.Sw.Sw.S.wS.wS.wS|wS.wS.wS.wSw.Sw.S|wSw.SwS.wS.wS.wS|wS.wS.w.S.wSw.S.wS|wS.wSw.S.wSw.SwS|wS.wS.wS.wS.wSw.S|w.SwS.wS.wSw.SwS|wS.wS.wS.wS.wS.wS|w.SwS.w.S.wSw.Sw.S|wS.wS.wS.wS.wS.wS|wS.wS.wS.wSw.Sw.S|wS.wS.wS.wS.wS.wS|
alex-4	wS.w.Sw.S.wS.wSw.S|wS.wS.wS.wSwS.w.S|wS.wSw.S.w.Sw.Sw.S|wSw.S.wS.wS.wS.wS|w.Sw.Sw.S.wS.w.S.wS|wSw.Sw.S.wSw.SwS|wS.wSwS.wS.wS.wS|wS.wSw.S.wS.wS.wS|wS.wS.wS.wS.wSw.S|wS.wSw.S.w.S.wSw.S|wS.wS.w.S.wS.w.S.wS|wSw.Sw.S.wS.wS.w.S|wSw.Sw.S.w.SwSw.S|wSw.Sw.S.wS.wS.w.S|wSw.Sw.S.wS.w.SwS|
alex-5	wS.wS.wS.wSw.S.wS|w.S.wS.wS.wSw.Sw.S|wSw.Sw.S.wS.wS.w.S|wS.wSw.S.wSwS.wS|wS.wSw.S.wS.wS.wS|wS.wS.wS.wS.wS.wS|w.Sw.S.wS.wS.wS.wS|w.S.w.Sw.S.wS.wS.wS|wS.wS.wS.wS.wS.wS|w.SwSw.S.wSwS.wS|wS.wSw.S.wS.w.S.wS|w.SwSw.S.wS.wSw.S|wS.wS.wS.wS.w.SwS|w.SwS.wS.w.S.wS.wS|w.S.w.S.wS.wS.wS.w.S|w.Sw.Sw.S.wS.wS.wS|
alex-6	wS.wSw.S.wS.wS.wS|wS.wSw.S.wS.wS.wS|wSw.S.wS.wSw.S.wS|wS.wS.wS.wS.w.S.wS|w.Sw.Sw.S.wS.wSw.S|wS.wSw.S.wS.wS.wS|wS.wS.wS.wSwS.wS|wS.wSw.S.wS.wS.w.S|wS.wS.wS.wSw.S.wS|w.SwS.wS.wS.wS.w.S|w.SwS.wS.wS.wS.wS|wS.wS.w.S.wS.wS.wS|wSw.SwS.wSw.Sw.S|wSw.Sw.S.wS.wSw.S|w.S.w.Sw.S.wS.wS.wS|
alex-7	wSw.Sw.S.wS.wS.w.S|w.Sw.Sw.S.wSw.Sw.S|wS.wS.wS.wS.wS.wS|wSw.SwS.wS.wS.wS|wSw.S.wS.wS.wS.wS|wS.w.SwS.wS.wSw.S|wSwS.wS.wSw.Sw.S|wSw.Sw.S.wS.wS.wS|wS.wS.wS.wS.wSw.S|wS.wSw.S.wSw.S.wS|wSw.Sw.S.wS.wS.wS|wSw.SwS.wS.wSw.S|wSw.Sw.S.w.Sw.Sw.S|w.S.wSwS.wSw.SwS|w.Sw.S.wS.wS.wSw.S|wSw.Sw.S.wS.wSw.S|
alex-8	wS.wS.wS.w.Sw.S.wS|wS.wS.wS.w.S.wS.wS|w.Sw.SwS.wS.wS.w.S|wS.wSw.S.wS.wS.wS|wS.wSw.S.wS.wSw.S|w.SwS.wS.wSw.Sw.S|wSw.Sw.S.wSw.Sw.S|wS.wS.wS.wS.w.Sw.S|wSwS.wS.wSwS.w.S|wS.w.Sw.S.wS.wS.wS|wSwS.wS.w.Sw.Sw.S|wSw.Sw.S.w.Sw.S.wS|wSw.Sw.S.wS.wS.w.S|w.Sw.Sw.S.wS.wS.wS|wS.wS.wS.wS.wS.wS|wS.wS.wS.wS.wSw.S|
alex-9	wSwS.wS.wS.w.S.w.S|wS.wS.w.S.wSw.Sw.S|wSw.S.wS.wS.wS.wS|wSw.SwS.wS.wSw.S|wS.wS.w.S.wS.wS.wS|wS.w.SwS.wS.wS.w.S|wS.wS.w.S.wSw.Sw.S|wSwS.w.S.wSw.SwS|w.Sw.SwS.wSw.Sw.S|wS.wSwS.wSw.S.wS|wSw.SwS.wS.wSw.S|wS.w.Sw.S.wSw.Sw.S|w.S.w.Sw.S.wS.w.S.wS|w.Sw.SwS.wSw.Sw.S|wS.w.Sw.S.wSw.Sw.S|w.S.wSw.S.wS.w.S.wS|wSw.Sw.S.wS.w.Sw.S|wS.wS.wS.wS.wS.wS|wS.wS.wS.wSw.Sw.S|
alex-10	wSw.S.w.S.wSw.Sw.S|wS.wS.wS.wS.wS.w.S|w.S.w.S.wS.wSw.S.wS|wS.wS.wS.w.SwS.wS|wSw.Sw.S.wSw.Sw.S|wSw.Sw.S.wS.wS.wS|wS.wS.wS.wS.wS.wS|w.Sw.Sw.S.wSwS.wS|wS.w.S.wS.wS.wSw.S|wSw.Sw.S.wS.wS.w.S|w.S.wS.w.S.wS.wSw.S|
alex-11	w.Sw.Sw.S.wS.wSw.S|w.Sw.SwS.wSw.Sw.S|wS.wS.wS.wS.w.SwS|wS.wSwS.w.S.wSw.S|wS.wS.wS.wSwS.wS|w.Sw.Sw.S.wS.wS.wS|wS.wS.wS.wS.wSw.S|wS.wSwS.w.SwS.wS|wS.wSw.S.wS.w.Sw.S|w.Sw.Sw.S.wS.wS.wS|wS.wS.wS.wSw.Sw.S|
alex-12	wS.w.Sw.S.wS.wS.wS|wSw.SwS.w.SwS.wS|wSw.S.wS.wS.wSw.S|wS.wS.wS.wS.wS.wS|wS.wS.w.S.wS.w.S.wS|wS.wS.w.S.wS.wSw.S|wS.wSwS.wS.wSw.S|w.Sw.S.wS.wSw.Sw.S|wS.w.S.wS.w.Sw.Sw.S|wSwS.wS.wSw.S.wS|w.Sw.S.wS.wSw.SwS|wSw.Sw.S.wS.w.Sw.S|
alex-13	wS.w.Sw.S.wS.wSw.S|w.S.w.Sw.S.wSwS.wS|wSwS.w.S.w.Sw.Sw.S|wSw.S.w.S.wS.wS.wS|wSw.Sw.S.wS.wS.wS|wSw.Sw.S.wS.wS.wS|wS.w.Sw.S.wSw.SwS|wS.wS.w.S.wS.wS.wS|wS.wS.wS.wS.w.Sw.S|
alex-14	wS.wS.wS.w.Sw.Sw.S|w.S.wSwS.w.Sw.S.wS|wSw.SwS.wS.wS.wS|w.SwS.wS.w.Sw.S.wS|wS.w.SwS.wS.wSw.S|w.Sw.Sw.S.wS.wS.wS|wSw.Sw.S.wS.wS.wS|wSwS.wS.wS.wS.wS|wS.wS.wS.wSw.Sw.S|wS.w.Sw.S.wS.wS.wS|wSw.Sw.S.wS.wS.wS|wS.wS.wS.wSw.Sw.S|wS.wS.wS.wSw.S.wS|wSwS.w.S.wSwS.w.S|wS.wS.wS.wS.w.S.wS|wS.wSw.S.wS.wSw.S|wS.wSw.S.wS.wSwS|
alex-15	wS.wS.wS.wSw.S.wS|w.Sw.Sw.S.wS.wSwS|wS.wSwS.w.Sw.Sw.S|wS.wS.wS.w.S.wSw.S|wS.wSw.S.wS.wS.wS|w.Sw.SwS.wSw.S.wS|wS.w.Sw.S.wS.wSw.S|wS.wSw.S.wS.w.Sw.S|wSw.Sw.S.wS.wS.wS|wS.wS.w.S.wS.wS.w.S|wS.wSw.S.w.Sw.Sw.S|wSw.Sw.S.w.S.wS.w.S|wS.wS.wS.wS.wS.wS|wSw.SwS.w.S.wS.wS|wSw.Sw.S.wSw.Sw.S|wS.wS.wS.wS.wS.wS|wS.wS.wS.wS.wSw.S|
alex-16	w.Sw.SwS.wSw.Sw.S|wSwS.w.S.wS.wSw.S|wS.w.Sw.S.wS.w.Sw.S|wS.wS.wS.wSw.Sw.S|wS.wSw.S.wSw.Sw.S|wSw.SwS.wS.wS.wS|wS.wS.w.S.wS.wSw.S|wS.wS.wS.wS.wS.wS|w.Sw.SwS.wS.w.S.wS|wS.wS.wS.wS.wS.wS|wSw.S.wS.wS.wSwS|wS.wS.wS.wS.wSw.S|w.Sw.Sw.S.wS.wSw.S|wSw.S.wS.wSw.Sw.S|wS.wS.wS.wS.wSw.S|wS.w.Sw.S.wS.wS.w.S|
alex-17	w.SwS.wS.wS.wS.wS|wS.wS.wS.wS.wSwS|w.Sw.SwS.wSw.SwS|wS.w.Sw.S.w.SwS.wS|wS.wS.wS.w.Sw.S.wS|wSw.Sw.S.wS.wS.wS|wS.wS.wS.wS.wS.wS|wS.wS.wS.wS.wS.w.S|wS.wSw.S.wSw.Sw.S|w.SwS.w.S.w.Sw.Sw.S|wS.wS.w.S.wS.wSw.S|wS.wSwS.w.SwS.wS|wSwS.wS.w.Sw.Sw.S|w.Sw.SwS.wS.wSw.S|wSw.Sw.S.w.Sw.SwS|
alex-18	wS.wSw.S.w.SwS.wS|wSw.S.wS.wS.w.S.wS|wS.wSw.S.wS.wS.wS|wS.wS.wS.wSw.Sw.S|wS.wSw.S.wSwS.wS|wS.wS.w.S.wS.wSw.S|wS.wS.wS.wSw.Sw.S|wSwS.wS.wS.w.S.wS|wSwS.wS.wSw.Sw.S|w.SwS.w.S.wSw.S.wS|wS.wSw.S.wS.wS.wS|wS.wS.wS.w.Sw.Sw.S|
alex-19	wS.w.S.w.S.wS.wS.wS|wS.w.Sw.S.wS.w.Sw.S|wSw.SwS.wSwS.wS|wS.wS.wS.wSw.SwS|wSw.S.wS.wS.wSw.S|wS.wSw.S.wSwS.w.S|
alex-20	wSw.SwS.wS.wS.wS|wS.wS.wS.wS.wS.wS|wS.w.SwS.wSw.S.wS|wSw.Sw.S.wSw.Sw.S|wSwS.wS.wS.wSwS|wS.wS.wS.wS.wS.wS|wS.wS.w.S.wS.wSw.S|wS.wS.wS.wS.wS.w.S|wS.wSw.S.wS.wS.wS|wS.wS.wS.w.SwSw.S|w.SwS.wS.wS.wS.wS|w.Sw.Sw.S.wS.wS.wS|w.SwS.wS.wS.wS.wS|
iamb6-1	wSw.Sw.Sw.S.wS.wS|wS.wS.wS.w.Sw.Sw.S|wSw.Sw.SwS.wSw.S|wS.wS.wSwS.w.SwS|wS.w.SwSw.SwS.wS|wS.wS.wS.wS.wS.wS|wS.wS.w.Sw.SwS.w.S|wS.wS.w.Sw.Sw.S.wS|wSw.Sw.SwS.wS.wS|wS.wSw.Sw.Sw.Sw.S|wSw.Sw.Sw.SwS.wS|wS.wS.wSwS.wS.wS|wSw.Sw.SwS.w.Sw.S|
iamb6-2	wS.w.S.wS.wS.wS.wS|wS.wS.wS.wSw.Sw.S|wS.wS.wSw.Sw.Sw.S|wS.wS.wS.wS.wSw.S|wS.w.Sw.Sw.Sw.SwS|w.S.wS.wSwS.wSw.S|wS.wS.wS.wS.w.Sw.S|wSw.S.wS.wS.wS.wS|wS.w.Sw.S.wS.w.Sw.S|wS.wS.wS.wS.wSw.S|wS.wSw.S.wSw.SwS|wSw.Sw.S.wS.wS.wS|wSw.S.w.S.wS.wS.wS|
iamb6-3	wSw.Sw.Sw.SwS.wS|wS.wS.wSw.Sw.Sw.S|wSw.S.w.SwS.wS.wS|w.Sw.Sw.SwS.w.SwS|wS.wSw.Sw.S.wS.wS|w.S.wSw.Sw.Sw.Sw.S|wS.wS.wS.wS.wSw.S|wS.wSw.Sw.S.wS.wS|w.Sw.S.wS.wSw.Sw.S|wS.w.SwS.w.S.wSwS|wSw.SwS.w.Sw.SwS|wS.w.S.wS.wS.w.Sw.S|wSw.Sw.Sw.Sw.Sw.S|wS.wS.wSw.S.wS.wS|
iamb6-4	wS.wSw.Sw.Sw.Sw.S|w.Sw.Sw.Sw.Sw.SwS|wS.wS.wSw.SwS.wS|wS.wS.w.Sw.Sw.Sw.S|wSwS.wS.wSw.Sw.S|wS.wS.wS.wS.w.Sw.S|wS.wS.wS.wSw.SwS|w.Sw.S.wS.wSw.SwS|w.SwSw.Sw.Sw.Sw.S|w.Sw.S.wSwS.w.Sw.S|wS.wS.wSw.Sw.Sw.S|wS.wS.wS.wS.wS.wS|w.SwS.wS.wSwS.wS|wS.w.SwS.wS.wS.wS|wSwS.wSwS.wS.wS|wS.wSw.Sw.Sw.Sw.S|wS.wSw.SwS.w.S.wS|wS.wS.wSw.SwSw.S|
iamb6-5	w.Sw.Sw.S.wS.wS.wS|wS.w.SwS.wS.wS.wS|wS.wS.wS.wS.wS.wS|wS.wS.wSw.Sw.Sw.S|wS.wS.w.Sw.Sw.Sw.S|wS.wS.wS.w.Sw.SwS|wS.w.Sw.Sw.Sw.SwS|wS.w.Sw.SwS.wS.wS|wS.wSw.Sw.S.wS.wS|wS.wS.wSwS.wS.wS|
iamb6-6	wS.wSwS.wSw.Sw.S|wS.wS.wSwS.wS.wS|wS.wS.wS.wS.wS.wS|w.SwS.wS.wSw.S.wS|wS.wS.wS.wS.wS.wS|wSw.S.wS.wSw.S.w.S|wSwS.wS.wS.wS.wS|
iamb6-7	wS.wS.wS.wSw.S.wS|wS.wS.wSw.Sw.SwS|wS.w.SwS.wS.wSwS|wS.wSw.SwS.wS.w.S|wS.w.Sw.Sw.SwS.wS|wSw.S.w.SwSw.SwS|wS.wS.wSw.Sw.Sw.S|wS.wS.wS.wS.wS.wS|wS.wSw.Sw.Sw.Sw.S|wS.wSwS.wS.wS.wS|w.S.w.S.wSw.SwS.wS|wSw.SwSw.S.w.Sw.S|
iamb6-8	wS.wS.wS.w.Sw.SwS|wS.wS.wSw.Sw.SwS|wSw.Sw.Sw.SwS.wS|wSw.Sw.Sw.Sw.SwS|wSw.Sw.S.wS.wS.wS|w.Sw.Sw.SwS.wS.w.S|wSw.Sw.S.wS.wS.wS|w.S.wS.wSw.SwS.w.S|wS.wS.w.Sw.Sw.Sw.S|wSwS.wS.wSw.Sw.S|wS.wS.w.Sw.Sw.Sw.S|
iamb6-9	wS.wS.wS.w.Sw.Sw.S|wSw.Sw.SwS.wS.wS|wS.wS.wSw.SwS.wS|w.SwS.wSw.Sw.Sw.S|wS.wS.wSw.SwS.wS|w.SwS.wS.wSw.Sw.S|wSwS.wS.wS.w.SwS|wS.wS.wSw.Sw.S.wS|w.Sw.Sw.Sw.Sw.S.wS|wS.wS.wSw.S.wS.wS|wS.wS.wS.wS.wS.wS|
iamb6-10	wS.wSw.SwS.wS.wS|wS.wS.wS.wS.wSwS|w.Sw.Sw.SwS.w.SwS|wS.wS.wSw.Sw.Sw.S|wS.wS.wSw.SwS.wS|wS.wS.wS.wS.wS.wS|wSw.SwSw.Sw.Sw.S|wS.wS.wS.w.SwS.wS|wS.wSw.S.wS.wS.wS|wS.wS.wS.wS.w.S.wS|w.Sw.Sw.SwS.wS.wS|wS.wS.wS.wS.wS.wS|wS.w.Sw.S.wS.wS.wS|
iamb6-11	wSw.S.wS.wS.w.S.w.S|wS.wS.wSw.SwS.wS|w.Sw.Sw.S.wSwS.wS|wS.wS.wS.wSw.Sw.S|wSwS.wS.wS.wS.wS|wS.wSw.Sw.S.wS.wS|wSw.Sw.Sw.SwSw.S|wS.wS.wS.wSw.Sw.S|wS.w.S.wSw.Sw.Sw.S|wS.wS.wS.wS.wS.wS|wS.w.S.wS.wS.wS.wS|wSw.SwSw.Sw.Sw.S|
iamb6-12	w.S.wS.wS.wSw.Sw.S|wS.wSw.SwSw.Sw.S|wS.wSw.Sw.S.wS.w.S|wS.wS.w.SwS.wS.wS|wSw.Sw.SwS.wS.wS|w.SwS.wS.wSw.Sw.S|wS.wSw.Sw.S.wSw.S|wS.wSw.S.wSw.S.wS|w.Sw.Sw.Sw.S.wS.wS|wS.w.Sw.S.wS.wS.wS|wS.w.S.w.Sw.S.wS.wS|wS.wSw.Sw.Sw.Sw.S|wS.wSwS.wS.wS.wS|
iamb6-13	wS.wSw.SwS.w.Sw.S|wS.w.Sw.Sw.Sw.S.wS|wS.wS.wSw.Sw.SwS|w.Sw.SwS.wSw.SwS|wS.wSw.Sw.Sw.SwS|wS.wSw.SwSw.Sw.S|w.Sw.Sw.Sw.S.w.S.wS|w.Sw.Sw.S.wSw.Sw.S|wSw.SwSw.Sw.Sw.S|wS.wSw.SwS.w.Sw.S|wSw.Sw.SwS.wS.wS|wS.wS.wS.w.Sw.S.wS|wSw.S.wSw.S.w.SwS|wS.wS.wS.w.Sw.SwS|
iamb6-14	wS.w.Sw.SwS.wS.wS|wS.wSw.S.wS.wS.wS|wSw.Sw.S.wS.wS.w.S|wS.wSw.SwS.wSw.S|wS.wSw.S.w.Sw.Sw.S|wSw.Sw.Sw.Sw.S.w.S|wS.wS.wS.w.SwS.wS|wS.wSw.Sw.Sw.Sw.S|w.Sw.SwS.wS.wSw.S|wS.wSw.S.wSw.Sw.S|wS.wSw.Sw.SwS.wS|w.Sw.Sw.S.w.SwS.wS|w.SwSw.SwSw.Sw.S|wS.wSw.Sw.Sw.Sw.S|wS.wS.wS.wS.wSwS|wSwS.wS.wS.wSw.S|
iamb6-15	wS.w.Sw.SwS.wS.w.S|wSw.SwSw.Sw.Sw.S|wSw.Sw.S.wSw.SwS|wS.wS.wSw.Sw.Sw.S|w.Sw.SwS.wS.w.Sw.S|wSwS.wS.wS.wS.wS|wSw.Sw.SwS.wSw.S|
iamb6-16	wS.wS.wSw.Sw.SwS|w.SwS.wSw.Sw.S.wS|wS.wS.wS.wSw.S.wS|wS.wS.wSw.Sw.SwS|wS.wS.wS.wS.wS.wS|wS.w.S.w.Sw.S.wS.wS|wSw.Sw.SwS.w.S.wS|w.SwSw.S.wS.wS.wS|wS.wS.wS.wS.wSw.S|wS.wSw.S.wS.w.S.w.S|w.Sw.Sw.Sw.Sw.SwS|wS.wSw.S.wSw.S.wS|wS.w.SwSw.Sw.SwS|w.SwS.wS.wS.wS.wS|
iamb6-17	wS.wSwS.wS.w.SwS|w.S.wSw.SwSw.Sw.S|w.S.wSw.Sw.SwS.wS|wS.w.Sw.SwS.wSwS|wS.wSwS.wS.wS.wS|w.SwS.wSw.S.wS.wS|w.S.wSw.S.wS.wS.wS|wS.w.Sw.Sw.SwS.wS|wSw.Sw.SwS.wS.wS|w.S.wS.wS.wSw.Sw.S|wS.w.S.wS.wS.wS.wS|
iamb6-18	w.Sw.SwS.wSw.S.wS|wSw.Sw.Sw.SwS.wS|wSwS.wS.w.Sw.Sw.S|w.Sw.Sw.S.wS.wS.wS|wSw.Sw.SwSw.Sw.S|w.S.w.Sw.Sw.SwS.wS|wS.w.Sw.SwSw.Sw.S|wSw.Sw.S.wSwS.wS|wS.wS.wSw.Sw.Sw.S|wS.w.S.wSw.SwSw.S|
iamb6-19	wS.w.SwS.wS.wS.w.S|w.SwS.wSw.Sw.Sw.S|wSw.SwS.wS.wS.wS|w.SwSw.Sw.Sw.Sw.S|wSw.SwSw.SwSw.S|wSw.SwSw.SwS.wS|wS.wS.wS.wS.wSw.S|wS.wS.wS.w.Sw.S.wS|w.SwS.wSwS.wS.wS|w.Sw.S.w.Sw.S.wS.w.S|wS.wSw.Sw.SwSw.S|wS.wS.wS.wS.wSw.S|wS.wSw.Sw.Sw.S.wS|wS.wS.wS.wS.wS.wS|wS.wS.w.Sw.SwS.wS|
iamb6-20	wS.wSw.SwS.wS.wS|w.Sw.Sw.SwSw.Sw.S|wS.wS.wSw.Sw.SwS|wSw.Sw.SwS.wSw.S|wSw.SwS.wS.wS.w.S|wS.wS.w.SwS.wSwS|wS.wS.w.Sw.S.wS.wS|w.Sw.SwSw.Sw.S.wS|w.Sw.Sw.SwS.w.SwS|wS.wS.w.Sw.SwS.wS|wSw.Sw.Sw.SwS.w.S|w.S.wS.wSw.S.wS.w.S|wS.wSw.Sw.SwSw.S|wS.wSw.S.wSwS.wS|wS.wSw.S.wS.wSw.S|
12syl-1	ww.wS.www.SwS.SS|ww.SS.wS.w.wSw.S.w|ww.Sww.Sw.ww.Sw.w|ww.wS.SSS.SS.w.ww|SwS.w.SSww.Sw.Sw|Sw.w.ww.ww.wS.ww.w|w.w.w.Sw.Sww.ww.SS|SSS.www.SS.Sww.w|w.wS.www.wSwS.Sw|Sw.wS.wS.wwS.wS.S|ww.SS.S.wS.SS.w.wS|wS.ww.wS.w.www.SS|SS.wwS.wS.SSw.Sw|SS.ww.w.ww.wS.SSw|S.w.w.w.wSw.wSS.SS|SS.S.Sw.wS.Sw.Sw.S|wSw.wwS.Sw.wwS.S|
12syl-2	ww.wwS.wS.w.w.wS.w|wwSw.SS.S.Sww.Sw|ww.Sw.wS.SS.wSwS|wS.wS.SwS.SS.SS.w|w.SSw.ww.Sw.www.S|Sww.Sw.ww.w.wS.Sw|wSSw.SS.Sw.wSSw|Sw.ww.S.wwS.Sw.w.w|ww.S.Sw.wSS.w.www|wS.ww.wwSw.ww.S.S|ww.ww.ww.SSS.wS.w|w.wS.Sw.w.w.SwS.ww|S.w.S.w.w.w.Sw.ww.ww|SS.ww.ww.SS.wS.ww|ww.w.Sw.Sw.S.w.Sw.S|wS.wSww.wS.SwS.S|Sw.ww.wS.Sw.wS.w.S|S.SS.w.SS.SS.wS.wS|Sw.Sw.wSw.ww.S.wS|
12syl-3	wSw.Sww.Sw.w.ww.w|S.wSw.ww.wSSS.SS|Sww.wwSS.wSw.w.w|SSS.SS.SwS.SS.wS|ww.SS.www.ww.ww.w|S.wSS.S.Sw.w.SSw.w|www.ww.Sw.w.SSS.w|SS.ww.wS.www.Sw.w|Sww.wSS.SS.SSw.w|Sw.SSw.www.w.w.Sw|ww.SS.wS.Sw.Sw.Sw|wS.wSw.SS.www.SS|w.ww.Sww.SwS.SS.w|
12syl-4	SS.w.wS.Sw.ww.SSS|Sw.wSS.w.wS.SS.w.w|www.w.S.ww.Sw.SS.S|w.Sw.w.ww.ww.wS.w.w|SS.ww.SS.Sw.ww.ww|Sw.SS.ww.S.ww.w.SS|ww.S.ww.SS.SS.S.wS|w.Sw.www.wSS.www|w.wS.Sw.S.ww.wS.SS|Sw.w.wSw.wS.SS.wS|SS.w.w.wSw.SwS.SS|www.www.S.wSS.w.w|SS.Sww.Sw.wS.Sw.w|Sw.ww.ww.ww.www.S|wSw.Sw.S.wS.S.ww.S|wS.ww.Sww.Sww.Sw|Sw.w.SS.Sww.w.Sw.S|w.Sw.Sww.SS.w.S.w.w|SS.w.Sw.www.ww.ww|
12syl-5	ww.wSSw.wwww.SS|S.SS.SS.ww.wS.ww.w|S.wS.S.ww.wS.wwSw|ww.ww.ww.wwS.w.ww|SS.wS.ww.Sww.w.SS|Sw.wwww.ww.SS.Sw|SS.w.w.Swww.ww.Sw|S.ww.Sw.Sw.w.ww.S.S|
12syl-6	SwS.wS.ww.S.ww.w.S|SwS.S.wS.www.SS.w|wS.wS.w.SS.SS.Sw.S|SwS.ww.ww.S.SS.SS|SS.wS.wSw.SSS.w.w|ww.ww.ww.SS.www.w|w.wSw.Sw.SSww.w.w|Sw.ww.wS.w.wS.ww.w|Sw.ww.w.Sww.Sww.w|SS.Sww.w.SwS.S.Sw|www.wwS.wSw.wS.w|SS.w.S.S.w.S.S.w.SSw|
12syl-7	ww.S.S.SwS.Sw.ww.w|Sw.ww.ww.S.wwS.w.w|Sww.S.SSw.S.ww.ww|S.wS.SSw.Sw.SS.ww|w.wS.wS.SSSS.ww.w|S.SS.SSS.wS.ww.S.S|wSww.SS.SS.Sw.wS|SS.Sw.w.wS.wS.Sw.w|w.ww.S.Sw.SSw.wS.S|SwS.ww.w.Sw.S.Sw.w|Sw.S.S.ww.SSS.ww.w|SS.w.w.wS.w.wS.ww.w|SS.wSw.SwSw.wS.S|Sw.Sw.w.S.Sw.wS.Sw|
12syl-8	wS.ww.wSw.w.ww.S.S|w.ww.wwS.wSw.w.S.w|ww.Sw.www.SS.Sw.w|Sw.Sw.ww.SS.wwS.w|SS.wwS.SwS.Sww.w|S.Sww.S.wS.SSw.ww|ww.Sw.SS.S.S.ww.Sw|w.wS.S.w.Sw.Sw.w.wS|ww.SSw.wSw.wS.SS|w.SwS.S.SS.wS.Sw.w|Sw.wS.S.wSw.SS.wS|Sw.ww.wSS.w.Sw.ww|Sww.SwS.wS.w.wSw|ww.www.ww.wwS.SS|SS.SS.wSw.wS.Sw.w|w.SS.ww.S.wS.Sw.S.S|ww.Sw.SSSw.wS.Sw|ww.SS.w.ww.Sw.SSS|
12syl-9	ww.w.w.wwS.wwSS.w|SS.wSS.S.S.w.wS.w.w|w.w.ww.SSSS.w.Sw.S|SwS.S.w.Sw.wSS.ww|Sw.www.Sw.ww.SS.w|wwSS.wS.wS.wS.SS|SSw.S.Sw.wS.S.ww.S|Sww.Sw.wS.wwS.ww|ww.Sw.wS.w.w.ww.SS|wSw.wSw.ww.wSSS|SSw.wS.SS.SSS.wS|SS.ww.SwS.SS.SSS|ww.www.wwww.w.wS|SS.w.ww.SS.Sww.S.w|
12syl-10	w.wSw.Sw.Sw.SS.SS|ww.SS.SS.w.ww.Sw.S|wwS.ww.SS.ww.SS.w|wS.wS.ww.ww.wSS.S|Sw.ww.wS.ww.SS.ww|w.www.ww.ww.Sw.ww|ww.www.wSw.SwS.S|wS.S.S.wwS.ww.Sw.S|wSS.wS.Sw.w.wS.wS|w.wSw.Sw.Sw.SSS.S|w.wS.Sw.ww.SwS.wS|Sw.wS.ww.S.Sw.Sw.w|w.wS.SwS.wS.wS.wS|
12syl-11	wwSw.wS.Sw.wSw.S|S.wS.wSS.ww.Sw.S.S|wwS.www.ww.ww.Sw|Sw.wwS.SSS.wSS.w|ww.ww.wS.w.S.wSSS|Sww.SSwS.Sw.Sw.w|wS.SS.SS.ww.Sww.S|ww.wS.ww.S.SS.Sww|Sw.S.ww.ww.ww.ww.w|Sw.SS.S.w.w.w.wS.S.w|wwS.SS.wSS.ww.SS|S.w.SSw.SS.S.w.SS.S|wwS.w.SS.wS.S.wS.S|www.Sw.SSw.wSw.w|Sw.Sw.Sw.wSw.ww.S|wSw.ww.wS.www.Sw|wSw.Sw.Sw.Sw.wSS|
12syl-12	www.Sw.S.Sw.wS.Sw|SSw.ww.Sw.wS.wS.w|SS.SS.Sw.www.w.ww|Sw.Sww.Sw.SS.Sww|ww.ww.Sw.SS.ww.wS|wS.SSSS.ww.Sw.wS|SwS.wS.Sw.S.wSw.S|Sw.SSS.Sw.wwS.wS|wSwS.wSw.www.w.w|w.Sw.wSw.SwS.wSS|S.Sw.wS.wS.SSS.Sw|wwww.Sw.ww.ww.w.S|Sw.ww.wS.SS.w.SSS|wwS.ww.ww.wS.wS.w|
12syl-13	SS.ww.SS.S.SSwS.w|S.www.Sw.w.S.wSw.S|ww.Sw.Sw.ww.ww.wS|ww.ww.Sww.Sw.ww.w|wS.w.www.Sw.ww.ww|wS.S.w.Sw.w.wSw.ww|SS.Sw.ww.SS.wSw.w|Sw.S.ww.SSS.wS.ww|Sw.ww.ww.S.w.S.S.Sw|w.SSw.w.wS.wSSw.S|SS.wS.w.S.ww.SSwS|S.Sw.SwS.Sw.ww.w.S|S.Sw.wS.w.S.w.Sw.Sw|wSS.Sw.Sw.wS.wwS|Sww.S.Sww.Sw.SSw|
12syl-14	Sww.wwS.ww.S.wS.w|wS.SS.w.SSw.wS.w.w|SS.SS.S.SS.wS.wS.w|wSw.wwwS.SS.wS.S|w.wS.Sw.S.Sww.Sww|ww.wS.wS.ww.Sw.ww|SS.wSS.ww.wSw.wS|ww.wS.Sw.wS.S.SS.S|SS.ww.wS.Sw.SSw.w|w.S.SS.Sw.ww.www.S|wwS.w.Sw.wSw.ww.w|SS.S.ww.Swww.wSw|ww.w.S.SSww.wwS.w|SS.S.Sw.www.SSS.S|S.ww.S.ww.Sw.S.Sw.w|
12syl-15	ww.wS.SwSw.S.wS.S|Sw.SS.w.Sw.Sw.S.wS|wS.w.ww.wS.S.w.SS.S|w.Sw.S.ww.wS.SS.w.S|Sw.Sw.wwS.Sw.Sww|w.ww.wwS.ww.Sw.w.S|ww.Sw.SS.wwS.Sw.S|Sw.ww.wS.wSS.Sw.S|ww.Sw.w.Sw.Sw.Sww|S.S.wS.wSw.SS.w.SS|SS.S.www.S.SS.wS.w|w.wS.SS.wSw.w.Sw.w|SS.Sw.Sw.SS.wSS.S|wS.ww.ww.SSwS.SS|
12syl-16	Sw.SSSw.S.w.wS.w.w|w.Sw.SSS.ww.wwS.w|SS.SS.ww.w.Sw.Sww|S.Sww.Sw.SS.w.wS.S|Sw.www.SS.www.wS|wS.ww.w.Sw.w.wSww|Sw.wSw.Sw.w.w.Sw.S|w.w.wS.Sw.wS.w.Sw.w|wS.Sw.SS.wS.ww.w.w|SSS.SwSw.www.SS|SS.S.wS.ww.wS.w.wS|SS.Sww.ww.SS.w.wS|SwS.ww.SS.wS.SS.S|S.wSw.Sww.SS.wS.S|
12syl-17	SwS.S.wwSw.w.www|SSS.w.wS.Sw.Sw.ww|wwS.wS.SSw.wS.SS|w.ww.ww.wS.Sw.S.Sw|SS.Sw.Sw.Sw.wS.w.w|S.SS.ww.ww.SS.S.ww|ww.Sw.wSwS.w.w.wS|SS.ww.ww.Sw.www.w|S.w.Sw.SS.w.ww.Sw.S|
12syl-18	S.w.wS.SS.wwS.wS.w|Sww.wS.SSw.wSSS|wwwS.SSw.S.ww.ww|Sw.ww.ww.SS.wS.Sw|Sw.S.ww.ww.w.S.www|ww.wwSw.wS.wS.w.w|S.ww.SSSS.w.S.S.Sw|Sw.ww.wS.Sw.S.wS.S|Sw.S.SS.SSw.wS.S.S|wS.w.www.S.www.SS|wS.SS.Sw.w.wS.Sw.w|SSw.SwSw.wS.SwS|Sw.wS.SwSw.S.Sw.w|ww.ww.Sw.ww.Sww.S|
12syl-19	wS.wSS.Sww.Sw.w.S|w.wSw.Sw.SS.SS.ww|wS.Sw.w.ww.Sw.wS.S|Sw.ww.S.S.S.ww.wwS|wS.ww.wS.wSS.ww.w|ww.w.SSw.Sw.wS.Sw|wS.Sw.ww.ww.w.Sw.S|Sw.wSS.Sw.w.w.ww.w|www.wS.Sw.wS.ww.S|S.S.SS.ww.w.Sw.ww.S|wwS.Sw.wS.SwS.SS|ww.Sw.Sw.wS.SwS.S|
12syl-20	ww.w.Sww.Sw.wS.w.S|SwS.Sw.wSSS.www|wS.wS.wS.w.wS.SS.w|SwS.wS.wS.ww.Sw.S|Sw.wwS.SSw.wS.ww|SS.S.w.SwS.ww.SS.S|w.S.ww.SSS.w.ww.wS|Sw.SS.Sw.ww.Sw.SS|S.ww.Sww.wS.wS.wS|Sw.wS.Sw.Sw.Sw.wS|w.Sww.Sw.www.Sw.S|w.ww.ww.SSw.www.S|
alexFrench-1	S.ww.SS.S.wS.Sw.SS|w.S.SS.SS.Sw.wS.wS|ww.ww.wS.SwS.ww.S|S.SSww.S.SwS.ww.S|SS.wS.w.S.SwSw.w.S|wS.w.SSS.SSw.w.wS|wS.wS.S.S.wwS.SSS|w.w.wS.wS.wS.Sw.S.S|wwS.wwS.Sww.Sw.S|w.Sw.wwS.wS.SSw.S|Sw.ww.S.S.wS.SSw.S|w.SSSS.S.wSS.SwS|S.Sw.Sw.S.Swww.w.S|w.S.wS.wS.wSw.ww.S|wS.wS.S.S.wSw.wwS|ww.w.ww.S.ww.SS.S.S|wS.wS.wS.SS.Sw.wS|Sw.SwS.S.wS.SS.SS|SS.Sw.SS.S.ww.wS.S|S.w.Sw.SS.wwww.SS|ww.ww.wS.SSS.SS.S|SS.Sw.wS.SS.Sw.SS|
alexFrench-2	wSS.wwS.Sw.wS.wS|Sw.S.SwS.wS.SS.wS|wS.ww.S.S.w.Sw.ww.S|Sw.ww.wS.SS.ww.wS|Sw.SS.wS.S.Sw.S.wS|Sww.ww.S.ww.w.wwS|ww.Sw.S.S.Sw.wwS.S|w.Sw.Sw.S.wS.SS.wS|SS.S.Sw.S.SSSS.wS|Sw.Sww.S.SS.Sww.S|SS.Sw.SS.ww.SwS.S|
alexFrench-3	SS.S.wSS.www.ww.S|SSSS.wS.wSw.wwS|S.wS.w.wS.Sw.SSS.S|wSw.wwS.wS.ww.SS|SS.SS.wS.wS.Sw.w.S|ww.S.wwS.ww.ww.S.S|wwS.SSS.Sww.wS.S|w.SS.ww.S.ww.wSSS|wS.wwwS.Sw.wSS.S|ww.SS.SS.S.SSS.SS|wSw.w.SS.Sww.SwS|
alexFrench-4	S.SS.wS.S.Sw.SSS.S|S.wS.wS.S.ww.Sw.w.S|wS.Sw.SS.w.w.w.wS.S|wS.ww.wS.wS.ww.wS|wS.SwS.S.SS.wS.wS|ww.SwS.S.w.ww.wwS|S.Sw.ww.S.Sw.Sw.w.S|Sw.w.SS.S.w.Sw.wwS|Sw.Sw.SS.wS.wwS.S|SS.S.SS.S.wSS.wS.S|wwS.SS.S.Sw.wS.wS|wS.Sw.wS.w.wwSw.S|ww.wSw.S.Sw.SwS.S|wS.Sw.wS.SS.SS.SS|ww.w.Sw.S.Sw.www.S|ww.w.Sw.S.Sw.ww.wS|
alexFrench-5	SwSw.SS.SS.SwwS|w.SS.wSS.Sw.wSw.S|Sw.SS.wS.wS.Sw.SS|w.w.ww.SS.SS.S.ww.S|SS.ww.w.S.S.SSw.wS|wwwS.S.S.ww.Sw.SS|SS.Sw.SS.wSS.wSS|Sw.www.S.wS.SS.SS|wwS.wS.S.ww.wS.S.S|ww.ww.SS.ww.SS.SS|wSw.wS.S.S.wS.wSS|S.S.ww.w.S.w.Sw.wS.S|ww.wS.wS.wS.ww.SS|ww.Sw.SS.ww.w.wS.S|
alexFrench-6	Sw.SwSS.Sw.wSw.S|wSw.ww.S.ww.wSS.S|ww.wS.SS.w.Sw.Sw.S|Sw.S.SSS.SS.ww.SS|ww.Sw.wS.w.wS.ww.S|wS.SSw.S.ww.w.S.wS|wSS.Sw.S.Sw.Sw.wS|
alexFrench-7	w.SSS.wS.SSS.wS.S|Sw.w.w.wS.Sw.wwSS|S.wS.wwS.w.ww.S.wS|SwS.wwS.Sww.wwS|S.SS.wS.S.ww.wS.wS|wS.Sw.SS.wwww.SS|wS.wS.SS.w.www.SS|ww.wS.w.S.ww.SS.wS|ww.SS.SS.SS.Sw.SS|ww.ww.wS.w.ww.w.SS|ww.SSw.S.S.ww.Sw.S|w.ww.wS.S.ww.w.Sw.S|ww.w.SwS.Sw.Sw.SS|S.wS.w.S.S.SwSS.w.S|
alexFrench-8	Sw.Sw.SS.wSS.ww.S|SSw.ww.S.w.ww.ww.S|ww.SwS.S.ww.wSwS|Sw.wS.S.S.SSw.SS.S|wS.w.ww.S.S.ww.wwS|wS.w.SS.S.Sw.SS.wS|w.wwS.S.S.S.w.S.wS.S|wS.SS.wS.w.Sw.wwS|ww.ww.SS.ww.Sw.SS|wS.wwSS.ww.ww.SS|SS.SS.SS.ww.S.ww.S|ww.Sww.S.Sw.www.S|SSS.ww.S.ww.wSw.S|ww.Sww.S.Sw.SS.wS|
alexFrench-9	S.w.S.SS.S.wSS.wwS|S.ww.wS.S.www.SSS|www.SSS.wwS.SS.S|SSS.SS.S.Sw.SS.wS|wS.wwS.S.wwS.Sw.S|SSS.wS.S.wwS.ww.S|S.wS.ww.S.ww.S.ww.S|SwSw.SS.Sw.SwS.S|wwS.ww.S.w.S.SS.w.S|Sw.Sw.w.S.SS.wS.SS|ww.wS.SS.wS.ww.SS|S.w.w.SSS.S.SS.SS.S|Sw.Sw.S.S.w.wS.wSS|
alexFrench-10	SSS.wS.S.wwww.wS|w.wSw.wS.wwww.w.S|ww.Sw.wS.SS.SSw.S|Sw.SS.SS.Sw.www.S|ww.SS.wS.SS.w.Sw.S|ww.wS.wS.S.ww.w.SS|S.wwS.SS.wwwS.wS|Sw.ww.SS.S.w.wS.wS|wSw.wS.S.wS.wwS.S|wS.ww.S.S.wS.SS.w.S|SSS.SwS.www.w.SS|Sw.w.w.wS.w.SSS.wS|wSw.SS.S.w.wSS.SS|wS.wSS.S.ww.S.w.wS|SSS.wSS.wS.SS.wS|
alexFrench-11	wwww.SS.wS.S.ww.S|Sw.Sw.SS.ww.ww.wS|S.S.SSwS.Sw.Sw.wS|SSS.wwS.wS.ww.wS|ww.SS.wS.SSw.SSS|Sww.Sw.S.wwS.SS.S|w.ww.S.wS.wSww.SS|ww.ww.SS.ww.Sw.SS|Sww.ww.S.ww.ww.SS|wS.wSw.S.Sw.Sww.S|wSS.w.wS.S.S.ww.wS|SS.Sw.SS.wS.Sw.wS|wSS.w.SS.ww.wwS.S|wSS.w.wS.wSS.ww.S|S.wS.Sw.S.S.S.SwS.S|SwS.SS.S.w.wS.ww.S|
alexFrench-12	www.S.wS.www.S.SS|ww.Sww.S.SS.S.wwS|Sw.Sww.S.SS.wSw.S|Swww.wS.www.ww.S|wS.S.wwS.ww.SSS.S|SS.Sww.S.w.ww.wSS|wwww.S.S.ww.Sw.wS|wS.SS.S.S.Sw.S.Sw.S|wS.SSw.S.wwS.wSS|Sw.Sww.S.SS.Sw.wS|SS.Sww.S.wS.wS.SS|w.Sww.wS.w.SSS.SS|ww.wSS.S.Sw.SwS.S|w.wSw.SS.w.wwS.S.S|
alexFrench-13	Sw.SS.wS.SS.Sww.S|wS.SS.SS.SSw.wwS|Sw.Sww.S.Sww.SS.S|S.Sw.Sw.S.w.w.w.wS.S|SSS.wS.S.ww.wS.wS|w.w.S.Sw.S.wSS.ww.S|Sw.w.w.wS.SSww.SS|
alexFrench-14	ww.Sw.wS.Sw.SS.S.S|wS.Sww.S.Sw.Sw.SS|S.S.Sw.wS.wS.ww.w.S|SwS.wwS.S.SS.ww.S|SS.ww.wS.ww.SS.w.S|SS.wwS.S.wS.ww.wS|SS.ww.S.S.wS.Sw.wS|SSw.SSS.SS.wwS.S|S.SSSS.S.w.wSS.wS|Sw.S.SS.S.ww.S.SSS|Sw.wS.S.S.SS.wS.wS|ww.SS.wS.ww.wwSS|w.SS.SSS.wwS.SS.S|ww.www.S.wSS.Sw.S|wS.ww.SS.SwS.wwS|wS.wS.SS.wwSS.wS|wS.ww.SS.Sw.ww.SS|SS.wSS.S.ww.ww.w.S|ww.wSSS.Sww.wwS|ww.ww.SS.SS.SS.wS|wS.S.Sw.S.SS.wSS.S|
alexFrench-15	Sw.S.S.wS.wS.SwS.S|SS.S.SS.S.SS.wSS.S|SS.w.SSS.S.Sw.SSS|S.wS.Sw.S.wwS.Sw.S|Sw.Sw.w.S.S.Sw.Sw.S|SS.Sw.SS.w.ww.wwS|wS.Sw.SS.S.S.w.SS.S|ww.ww.SS.w.SwS.w.S|w.SS.Sw.S.ww.Sww.S|SSS.wwS.wwS.ww.S|w.wS.ww.S.SS.SS.wS|w.ww.S.SS.wS.wSwS|ww.Sw.SS.S.ww.SS.S|Sw.Sw.SS.wS.www.S|
alexFrench-16	SwS.wSS.Sw.S.Sw.S|Sw.S.SwS.ww.Sw.wS|SwS.wSS.ww.SS.SS|ww.www.S.Sw.Sww.S|SS.wSS.S.wS.w.Sw.S|w.ww.wS.S.ww.ww.wS|ww.S.w.wS.wS.S.SSS|w.wS.ww.S.SS.Sw.wS|wS.wS.SS.www.ww.S|SSS.wwS.wS.wS.SS|Sww.wS.S.S.w.ww.S.S|Sw.ww.wS.Sw.w.SSS|ww.Sw.wS.wS.wS.wS|
alexFrench-17	wS.wSw.S.Sw.Sw.SS|Sw.wwS.S.SS.SSS.S|Sw.Sww.S.Sw.wS.wS|Sw.w.Sw.S.ww.w.ww.S|wwS.SwS.wwS.SS.S|Sw.ww.SS.ww.Sw.w.S|SSww.SS.SS.ww.wS|ww.SSw.S.wS.wS.wS|wS.S.wS.S.w.SSww.S|Sw.SSS.S.ww.w.wSS|SSS.ww.S.w.SSSw.S|ww.SS.SS.www.Sw.S|ww.S.SS.S.wwS.w.S.S|SS.S.w.wS.SS.SS.SS|ww.SwS.S.wS.ww.w.S|ww.wS.SS.SS.wS.SS|
alexFrench-18	SS.w.ww.S.w.w.wS.wS|SwS.wS.S.S.Sw.S.SS|ww.Sw.SS.Sw.ww.w.S|S.ww.w.wS.wSw.S.SS|SS.Sww.S.SS.Sw.wS|wS.S.ww.S.Sw.Sw.SS|S.Sw.w.SS.S.ww.S.wS|ww.w.S.SS.SSw.Sw.S|SS.Sww.S.ww.Sw.SS|ww.w.wwS.S.w.ww.w.S|SS.Sw.wS.SS.www.S|Sw.ww.SS.Sw.w.wSS|wS.w.Sw.S.wSSw.w.S|wS.w.Sw.S.SS.SwS.S|wS.wwS.S.Sw.ww.SS|www.wS.S.SS.wSS.S|wwww.wS.Sw.ww.S.S|SS.w.ww.S.w.SS.SSS|
alexFrench-19	ww.ww.SS.Sw.SS.wS|ww.Sw.wS.Sw.SS.wS|SSS.S.wS.ww.ww.w.S|w.ww.SS.S.ww.wS.SS|Sw.SS.wS.ww.ww.SS|Sw.www.S.Sw.S.w.SS|ww.wS.SS.SS.S.SwS|w.Sw.wS.S.Sw.S.SwS|Sw.Sw.w.S.Sw.SSw.S|w.ww.Sw.S.ww.ww.SS|ww.wS.wS.Sw.Sw.SS|SS.wwS.S.wS.SS.wS|wSw.SSS.SS.Sw.w.S|ww.www.S.SwS.SSS|wSw.Sw.S.SS.Sw.S.S|ww.SS.wS.SSw.ww.S|SS.ww.wS.ww.wSS.S|Sw.S.SSS.Sw.ww.wS|wSww.SS.ww.wwS.S|
alexFrench-20	SS.SwS.S.wS.w.wwS|wS.wwS.S.Sw.wSw.S|w.wwwS.S.w.Sw.wS.S|SS.SS.w.S.ww.SwwS|Sw.Sw.wS.wS.wS.S.S|SS.ww.SS.wS.Sw.wS|w.ww.S.wS.wS.ww.SS|SS.Sw.wS.wwS.w.wS|ww.Sw.w.S.Sw.Sw.SS|w.Sw.wwS.wwSS.SS|
alexRomantic-1	S.S.S.S.wS.wS.ww.w.S|wS.SS.S.ww.S.wS.SS|Sw.SS.www.S.wS.SS|w.Sw.S.SS.wS.ww.S.S|wS.S.S.SS.wS.SSSS|ww.wS.w.Sw.S.wSw.S|w.Sw.S.ww.wS.ww.SS|SSS.S.w.S.S.S.wS.SS|S.SSS.wwSS.Sw.wS|ww.SS.wS.S.S.w.wwS|ww.wS.SS.wS.SSw.S|Sw.wS.SS.SS.SSwS|S.Sw.S.S.ww.S.wS.SS|Sw.SS.SS.SS.Sw.SS|ww.SS.Sw.SS.w.SwS|SS.SS.Sw.wS.wS.SS|SSw.S.SS.wS.S.Sw.S|SwwS.w.S.w.S.SwS.S|SS.wS.SS.SS.wS.wS|SS.wS.Sw.SS.ww.w.S|
alexRomantic-2	SS.wS.Sww.S.SSw.S|SSS.S.w.S.SS.S.wwS|ww.SS.Sw.SS.S.wS.S|SSS.S.wSw.S.wS.w.S|Sw.wS.wS.wS.ww.SS|w.ww.S.Sw.wS.ww.wS|Sw.SS.wS.wS.SS.S.S|Sw.S.S.wS.w.S.wSS.S|SS.wS.Sw.wS.w.ww.S|SS.SS.ww.wS.wS.w.S|SS.w.S.SS.S.S.wS.w.S|wS.SS.ww.w.S.S.wS.S|wS.SS.Sw.wS.wSw.S|SS.wS.Sw.wS.wS.S.S|wS.wS.SS.w.S.ww.wS|
alexRomantic-3	SwS.S.SS.wS.wSSS|wS.S.S.ww.S.S.wwS.S|wSw.S.wS.SS.SS.SS|wS.SS.ww.SS.SS.wS|wwS.S.ww.SS.S.wSS|w.S.wS.w.wSS.wS.SS|ww.wS.SS.wS.Sw.SS|Sw.SS.wwS.S.ww.SS|Sw.S.S.Sw.S.S.Sw.SS|w.w.wS.wSw.S.SSS.S|SS.wS.wwwS.w.wS.S|w.SwS.wS.wS.SS.wS|S.SwS.wS.SS.wSw.S|wwS.S.wS.S.S.Sww.S|wS.SS.wS.wS.ww.SS|Sw.wS.ww.wS.Sww.S|
alexRomantic-4	wS.wS.S.SwS.w.ww.S|wwSS.w.wS.S.wS.SS|w.ww.S.SS.wS.wwwS|wS.SS.SS.SS.Sw.w.S|www.S.Sw.S.S.ww.wS|ww.w.S.SwSS.w.wS.S|SwwS.w.S.wS.w.wS.S|Sw.SS.SSS.S.SS.wS|ww.wS.S.w.SS.Sw.SS|S.Sw.S.Sw.wS.w.wS.S|www.S.wSw.S.Sw.S.S|wS.wS.wwwS.wSS.S|SS.wS.SS.wS.S.SS.S|w.SwS.wwSS.wSw.S|
alexRomantic-5	SSw.S.wS.wS.wwS.S|S.wS.S.SwS.S.w.wS.S|Sww.S.S.SSS.www.S|ww.w.S.wSw.S.wSS.S|S.ww.S.SS.w.S.wS.wS|SS.SS.wS.SS.SS.SS|Sw.wS.Sw.SS.w.wSS|wS.SS.S.ww.S.w.SSS|Sw.wS.ww.w.S.ww.S.S|w.wS.S.SS.wS.ww.SS|Sw.wS.S.Sw.S.SSSS|Sw.S.S.wS.wS.wS.wS|SS.wS.w.S.SS.wS.wS|Sw.wS.SS.wS.wS.SS|w.w.SS.wwS.S.ww.wS|www.S.Sw.SS.wSS.S|Sww.S.ww.SS.wS.S.S|wS.wS.ww.wS.wwS.S|
alexRomantic-6	S.S.wS.w.Sw.S.Sw.SS|wS.SS.ww.wS.S.ww.S|Sw.S.S.wSw.S.ww.wS|wwwS.ww.S.S.www.S|SwSS.www.S.wSw.S|ww.wS.w.wS.S.wwS.S|wS.wS.SSS.S.SSw.S|wS.wS.w.ww.S.Sw.wS|Sww.S.SSS.S.SwwS|Sw.w.S.wSw.S.ww.SS|S.SS.S.SS.wS.ww.SS|Sw.S.S.SwS.S.wSw.S|S.wS.S.Sw.wS.wwS.S|SS.S.S.Sw.w.S.w.wwS|wSw.S.w.wS.S.w.ww.S|wS.wS.ww.wS.Sww.S|SS.SS.w.SSS.ww.w.S|S.wS.S.w.wS.S.wS.w.S|
alexRomantic-7	wwS.S.wS.wS.S.wS.S|S.Sw.S.SwwS.ww.wS|SS.wS.w.SS.S.wS.wS|wS.SS.w.SwS.wS.wS|ww.SS.ww.SS.wwS.S|SS.wS.w.SS.S.SSw.S|Sw.wS.Sww.S.wwS.S|wSwS.ww.SS.S.ww.S|w.S.S.S.Sw.SS.SSw.S|SS.w.S.www.S.wS.wS|Sww.S.S.wS.S.SS.wS|ww.w.S.ww.wS.ww.wS|wS.SS.ww.wS.SS.SS|Sw.wS.Sw.SS.SS.SS|wS.SS.S.wS.S.w.wS.S|SS.wS.wS.S.S.SS.SS|
alexRomantic-8	www.S.wSw.S.Sww.S|w.SSS.Sw.SS.wSw.S|Sw.wS.S.SS.S.Sw.w.S|SS.S.S.S.S.wS.www.S|S.w.SS.wS.S.S.w.S.S.S|w.wS.S.w.wS.S.wwSS|wS.wS.SS.wS.wS.S.S|S.wS.S.wS.SS.SS.wS|SS.wS.Sw.wS.wSS.S|SS.wS.Sw.wS.Sw.wS|Sw.SS.S.ww.S.wS.wS|SS.wS.SwwS.wS.wS|wS.wS.Sww.S.wS.wS|ww.w.S.SSw.S.ww.SS|Sw.wS.ww.wS.Sw.wS|SwS.S.wS.wS.SS.wS|
alexRomantic-9	Sw.wS.wS.SS.S.SSS|SSw.S.SS.S.S.wSS.S|ww.wS.wS.wS.ww.wS|S.wSS.SwS.S.SSSS|wSSS.ww.wS.wS.SS|wSS.S.www.S.SS.S.S|wwSS.ww.SS.SS.SS|S.w.SS.wSw.S.wS.SS|
alexRomantic-10	wSS.S.SS.wS.S.SwS|Sw.wS.wwS.S.SS.SS|ww.S.S.w.wS.S.SS.SS|S.w.wS.Sw.wS.SSS.S|ww.wS.ww.w.S.w.SS.S|wSw.S.ww.wS.S.SS.S|S.S.w.S.w.w.SS.ww.w.S|ww.wS.SS.wS.SwS.S|wwS.S.w.Sw.S.ww.wS|Sw.SS.Sw.S.S.wS.SS|
alexRomantic-11	wSw.S.ww.wS.S.wSS|w.Sw.S.SSS.S.ww.wS|wS.SS.wSS.S.ww.SS|wwS.S.SS.wS.Sw.wS|wSS.S.wS.S.S.SS.wS|Sw.wS.SwS.S.wS.wS|SSw.S.SS.wS.S.Sw.S|wSw.S.ww.SS.wwwS|w.Sw.S.wS.w.S.wS.wS|www.S.www.S.w.wwS|SS.wS.ww.SS.S.S.SS|wS.SS.SwSS.Sww.S|
alexRomantic-12	Sw.wS.ww.SS.Sw.SS|ww.SS.wSS.S.wwwS|w.SwS.www.S.Sw.wS|SS.wS.Sw.w.S.ww.wS|Sw.SS.ww.wS.Sw.SS|Sww.S.w.SwS.SSw.S|SS.wS.w.Sw.S.ww.S.S|SwwS.SwS.S.wS.SS|Sw.SS.wS.w.S.ww.w.S|w.w.SS.Sw.SS.SS.wS|ww.wS.w.SSS.SSw.S|wSw.S.S.wS.S.wS.SS|ww.wS.wSS.S.ww.wS|SS.SS.wSSS.Sw.w.S|
alexRomantic-13	wS.wS.w.w.SS.wSSS|www.S.wS.SS.Sw.wS|SS.S.S.wS.SS.S.ww.S|wSw.S.S.Sw.S.S.ww.S|wS.SS.w.w.SS.Sww.S|ww.SS.www.S.SSw.S|SS.SS.www.S.Sw.wS|Sw.wS.SwwS.S.SSS|wS.wS.S.wS.S.ww.w.S|ww.wS.wSw.S.SS.w.S|SwS.S.ww.SS.Sw.wS|SS.wS.Sww.S.ww.SS|
alexRomantic-14	Sww.S.Sw.wS.ww.S.S|wS.SS.www.S.SSwS|wwS.S.SS.wS.w.S.SS|ww.wS.wS.wS.ww.SS|w.w.wS.SwS.S.SS.wS|wwS.S.ww.SS.wSw.S|wSwS.S.ww.S.ww.SS|w.ww.S.wwS.S.SS.wS|Sw.wS.wwS.S.ww.SS|wS.wS.wS.SS.SS.S.S|w.w.wS.w.wSS.Sw.SS|Sw.wS.SS.wS.w.ww.S|Sw.SS.wSS.S.wS.wS|
alexRomantic-15	SwS.S.SS.SS.ww.wS|Sw.SS.SSS.S.wSwS|Sw.SS.wSw.S.w.w.SS|S.wS.S.Sww.S.wSS.S|S.SS.S.wwwS.wS.wS|wSw.S.w.ww.S.wSS.S|wwS.S.wwS.S.Sw.w.S|SS.SS.SS.SS.wS.wS|Sw.wS.SS.w.S.Sw.SS|wS.S.S.w.SSS.SwS.S|
alexRomantic-16	SS.SS.wS.wS.wS.SS|Sw.w.S.Sw.SS.www.S|wS.wS.Sw.SS.Sw.SS|SS.wS.wS.S.S.SS.wS|S.wSS.ww.S.S.SS.wS|ww.wS.ww.wS.Sw.SS|Sw.wS.Sw.wS.ww.SS|wS.SS.SwS.S.ww.wS|wS.wS.ww.S.S.S.SS.S|www.S.SwS.S.Sw.wS|www.S.ww.wS.SS.S.S|S.S.SS.w.SwS.SSS.S|
alexRomantic-17	Sw.S.S.ww.SS.w.S.wS|wS.S.S.SS.SS.SSw.S|w.Sw.S.SS.wS.wS.S.S|SwS.S.w.SS.S.ww.SS|Sw.w.S.S.Sw.S.wSS.S|wS.wS.ww.w.S.ww.wS|wS.w.S.S.S.wS.wS.wS|SwS.S.wSw.S.wS.wS|w.wS.S.w.wSS.Sw.w.S|SSS.S.S.wSS.Sw.wS|S.SS.S.Sw.SS.ww.wS|w.SS.S.Sw.wS.Sw.wS|ww.wS.Sw.wS.Sw.wS|Sw.SS.S.SS.S.www.S|Sw.wS.S.wS.S.S.SwS|wSS.S.SS.SS.wwS.S|ww.SS.wS.S.S.www.S|ww.wS.ww.w.S.SS.SS|
alexRomantic-18	ww.wS.Sw.wS.S.ww.S|www.S.wSS.S.ww.SS|S.ww.S.SSS.S.w.wS.S|wS.SS.SSS.S.S.SwS|www.S.wwS.S.SS.SS|w.SwS.Sw.wS.SS.SS|SwS.S.SSwS.SSwS|SS.wS.ww.SS.wS.SS|ww.SS.SS.SS.wSw.S|w.wS.S.w.SS.S.wS.wS|ww.SS.wS.SS.SSS.S|SSS.S.wSS.S.ww.SS|
alexRomantic-19	wS.wS.wSw.S.ww.wS|SS.wS.w.SS.S.wSS.S|Sw.SS.wS.w.S.wwwS|ww.wS.www.S.www.S|ww.wS.Sw.SS.SSS.S|SwwS.SS.SS.Sw.SS|w.Sw.S.ww.SS.wS.S.S|ww.SS.wSwS.S.ww.S|SS.wS.w.SS.S.SwS.S|SSSS.ww.SS.wS.SS|w.Sw.S.wSS.S.Sw.wS|wS.SS.S.SS.S.wwSS|
alexRomantic-20	w.SS.S.Sww.S.SSS.S|www.S.SS.wS.wS.S.S|ww.SS.SS.SS.SwS.S|w.wS.S.Sw.wS.ww.SS|ww.wS.SSw.S.SS.SS|Sw.SS.Sw.wS.wSwS|ww.wS.ww.wS.wS.S.S|SwS.S.wS.S.S.w.ww.S|wwS.S.www.S.SSS.S|ww.S.S.www.S.SwwS|S.w.wS.wwSS.SSw.S|w.wS.S.Sw.SS.wS.w.S|wwS.S.SS.SS.Sw.SS|Sw.wS.ww.wS.SwS.S|SSS.S.Sww.S.wSS.S|wwSS.Sw.SS.wS.wS|Sww.S.SS.SS.wS.wS|wSS.S.w.SSS.w.wS.S|ww.SS.S.SS.S.S.wS.S|www.S.ww.SS.wSw.S|wSSS.www.S.SS.wS|wS.w.S.www.S.ww.SS|
